 +  +  +  +  #  #  #  #  #  .  .  .  .  .  .  .  .  . 
 #  #  #  +  .  .  .  #  #  #  .  .  #  #  .  #  .  . 
 .  .  #  +  #  #  #  .  .  .  .  .  .  .  .  .  .  # 
 .  .  #  +  #  .  .  #  #  #  .  #  #  #  .  .  .  # 
 .  .  #  +  #  .  #  .  .  #  .  .  .  .  .  .  #  # 
 .  .  #  +  #  .  #  #  #  .  #  .  .  #  .  .  #  # 
 .  .  #  +  #  .  .  .  .  .  .  .  .  .  .  #  .  # 
 .  .  #  +  #  #  #  #  #  .  #  #  .  .  .  #  #  . 
 +  +  +  +  .  #  .  .  .  #  .  #  .  #  #  .  #  . 
 +  #  #  #  #  #  .  .  .  +  #  #  .  #  .  .  .  . 
 +  #  +  +  +  +  +  +  +  +  #  .  .  #  .  #  .  # 
 +  #  +  #  #  #  .  #  #  #  .  .  #  #  .  .  .  . 
 +  +  +  .  .  #  #  .  .  #  #  .  #  #  #  .  #  . 
 .  #  #  .  #  .  #  .  #  .  .  .  #  #  #  .  #  . 
 .  #  #  .  .  .  .  #  #  #  #  .  #  .  .  #  #  . 
 .  #  .  #  #  #  .  .  .  .  #  #  .  .  #  .  #  . 
 .  .  #  #  .  #  #  .  #  .  .  #  #  #  .  #  #  . 
 .  .  #  .  #  .  .  .  .  #  #  .  .  .  .  .  .  . 
 .  .  #  .  #  #  #  #  .  .  .  .  .  .  .  .  .  . 
