 +  +  +  #  #  #  #  #  .  .  .  .  .  .  .  .  .  .  .  . 
 .  #  +  +  +  +  +  #  #  #  #  #  #  #  .  .  .  .  .  . 
 .  #  #  #  .  .  +  +  +  +  +  +  .  #  .  #  #  #  #  . 
 .  .  #  #  .  .  .  #  #  #  .  +  .  #  .  .  .  #  .  . 
 .  #  #  #  .  #  .  .  .  #  #  +  #  #  #  .  #  #  #  . 
 .  .  .  #  .  .  .  #  .  .  #  +  +  #  #  #  +  +  +  + 
 #  #  .  #  .  #  .  .  #  .  #  #  +  #  #  +  +  #  #  + 
 .  .  .  .  .  #  .  #  .  .  .  #  +  #  +  +  #  #  #  + 
 #  #  #  #  .  #  .  #  #  .  #  #  +  +  +  #  .  .  #  + 
 .  .  .  #  .  .  #  .  .  #  .  .  .  #  #  #  .  #  #  + 
 .  #  #  #  #  #  .  #  .  #  .  #  #  .  #  .  .  .  .  + 
 .  .  .  .  .  #  #  .  #  #  #  .  #  .  #  .  .  #  .  + 
 #  .  #  .  #  #  .  #  .  #  #  .  .  #  #  .  #  #  #  + 
 .  .  .  #  .  #  .  .  .  .  #  .  #  .  .  .  .  +  +  + 
 #  #  #  .  #  #  .  #  .  .  #  .  #  #  #  #  .  +  .  # 
 .  .  .  .  #  .  #  .  #  #  #  #  .  .  .  .  #  +  .  . 
 .  #  .  .  .  .  #  .  .  .  #  #  #  #  .  .  #  +  #  # 
 .  .  #  #  #  .  #  #  #  .  .  +  +  +  +  +  +  +  .  . 
 .  .  .  .  .  .  .  .  .  .  .  +  .  .  .  .  .  .  .  . 
