 +  +  +  .  .  #  .  .  .  . 
 #  #  +  #  .  #  .  #  #  . 
 .  .  +  +  .  #  .  .  #  . 
 #  #  #  +  #  #  .  #  #  . 
 .  .  #  +  +  +  +  #  .  . 
 #  #  #  #  #  #  +  #  #  . 
 .  .  .  .  .  .  +  +  +  . 
 #  #  #  #  #  #  #  #  +  # 
 .  .  .  .  .  .  #  .  +  + 
 .  #  #  #  #  .  #  #  #  + 
