 +  +  +  #  #  #  .  .  .  .  .  .  .  .  . 
 #  #  +  #  .  .  .  .  #  #  #  .  .  .  . 
 .  .  +  #  .  #  .  #  .  .  .  .  #  .  . 
 .  #  +  #  .  #  .  #  .  .  #  .  #  #  . 
 .  .  +  +  +  +  +  #  .  .  #  .  #  #  . 
 #  #  #  #  #  .  +  #  .  #  #  #  .  #  . 
 .  .  .  .  #  .  +  #  .  .  .  .  .  #  . 
 #  #  #  .  #  .  +  .  #  #  #  #  .  .  . 
 .  .  #  .  #  .  +  #  #  .  .  #  #  .  # 
 .  .  #  .  .  .  +  +  +  +  +  +  +  #  . 
 .  #  #  #  .  #  #  #  #  #  #  #  +  +  + 
 .  #  .  .  .  .  .  .  .  .  #  .  .  #  + 
 #  #  .  .  #  #  .  .  #  #  #  .  #  .  + 
 .  #  .  .  .  #  #  .  .  .  .  .  .  .  + 
 .  .  .  .  .  .  #  #  #  #  #  #  #  .  + 
 .  .  .  .  .  .  .  .  .  .  .  .  .  .  . 
