 +  .  #  .  .  .  .  .  .  . 
 +  #  #  .  #  #  #  .  .  . 
 +  #  .  .  #  .  #  .  .  . 
 +  +  +  +  +  +  #  .  #  . 
 .  #  #  #  #  +  #  .  #  . 
 .  .  .  .  #  +  #  .  #  # 
 #  #  #  .  #  +  +  +  #  . 
 .  #  #  .  #  #  #  +  #  . 
 .  .  .  .  .  .  .  +  #  . 
 .  #  #  #  #  #  #  +  +  + 
