 +  +  +  +  +  +  +  +  +  +  +  +  +  +  + 
 #  #  #  #  #  #  #  #  #  #  #  #  #  #  + 
 #  +  +  +  +  +  +  +  +  +  +  +  #  #  + 
 #  +  #  #  #  #  #  #  #  #  #  +  #  #  + 
 #  +  #  +  +  +  +  +  .  #  #  +  #  #  + 
 #  +  #  +  #  #  #  +  .  #  #  +  #  #  + 
 #  +  #  +  #  +  +  +  .  #  #  +  #  #  + 
 #  +  #  +  #  #  #  #  #  #  #  +  #  #  + 
 #  +  #  +  +  +  +  +  +  #  #  +  #  #  + 
 #  +  #  #  #  #  #  #  +  #  #  +  #  #  + 
 #  +  +  +  +  +  +  +  +  .  #  +  #  #  + 
 #  #  #  #  #  #  #  #  #  #  #  +  #  #  + 
 #  #  #  #  #  #  #  #  #  #  +  +  .  #  + 
 #  #  #  #  #  #  #  #  #  .  +  #  #  +  + 
 .  .  .  .  .  .  .  .  .  .  +  +  +  +  # 
